1111111111111111111111111111111111
1E0000000000000C00000C000000000001
1010010100100000101001000000010101
10100100101010100010010000C0010101
1P0000000C00C0000000000000000000C1
10100100101010100010010000C0010101
1000000000100000000000011000000001
1000000000000100000000100000000001
10000C0010000000000011100000000001
100100000000000100000C000001110001
100110000000C000000000000000000001
1111111111111111111111111111111111