1111111111111111111
1C001100100000C10C1
1000111000P00000001
1000000010010001001
100C100010000000001
1000000010100000001
1000000010100000001
1000000010100000001
1000000010100000001
1000000010100000001
1000000010100000001
100000001010000C001
1000000010100000001
1000000010100000001
1000000010100000001
1000000010100000011
1C0010001C0000100E1
1111111111111111111
1111111111111111111
