1111111111111111111
11P11000100000C11E1
1000101000000000101
1000000010010001001
100C10001000C000001
1000000010100000101
1C0010001C000010101
1111111111111111111